{
    "name": "VI",
    "moves": 43,
    "spikes_move": 1,
    "key_x": 3,
    "key_y": 2, 
    "tiles": [
        " _p_   ",
        " rrr   ",
        "____   ",
        " _r__  ",
        " s rr__",
        " __r_s ",
        "    lr_",
        "   __g "
    ],
    "spikes": [
        "_______",
        "_______",
        "_______",
        "_00____",
        "_______",
        "_______",
        "_______",
        "_______"
    ]
}
