{
    "moves": 23,
    "spikes_move": 0,
    "tiles": [
        "1111_p1",
        "1__3__1",
        "__3_311",
        "__11111",
        "_2__2_1",
        "_2_2__5"
    ],
    "spikes": [
        "_______",
        "_______",
        "_______",
        "_______",
        "_______",
        "_______"
    ]
}
