{
    "moves": 23,
    "spikes_move": 0,
    "tiles": [
        "    _p ",
        " __s__ ",
        "__s_s  ",
        "__     ",
        "_r__r_ ",
        "_r_r__g"
    ],
    "spikes": [
        "_______",
        "_______",
        "_______",
        "_______",
        "_______",
        "_______"
    ]
}
