{
    "moves": 24,
    "spikes_move": 0,
    "tiles": [
        "1____11",
        "131____",
        "__11222",
        "__11___",
        "p_11_3_",
        "11114_3"
    ],
    "spikes": [
        "_______",
        "___11__",
        "_1__11_",
        "_____1_",
        "_______",
        "_______"
    ]
}
