{
    "moves": 32,
    "spikes_move": 0,
    "key_x": 0,
    "key_y": 5, 
    "tiles": [
        "111444_1",
        "11111161",
        "11_____p",
        "11_1_1__",
        "11__3__1",
        "_1_1_1_1",
        "_____3_1"
    ],
    "spikes": [
        "________",
        "________",
        "___11___",
        "__1_1___",
        "_____11_",
        "__1_1___",
        "________"
    ]
}
