{
    "moves": 43,
    "spikes_move": 1,
    "key_x": 3,
    "key_y": 2, 
    "tiles": [
        "1_p_111",
        "1222111",
        "____111",
        "1_2__11",
        "13122__",
        "1__2_31",
        "111142_",
        "111__51"
    ],
    "spikes": [
        "_______",
        "_______",
        "_______",
        "_00____",
        "_______",
        "_______",
        "_______",
        "_______"
    ]
}
