{
    "moves": 12,
    "spikes_move": 0,
    "tiles": [
        "   rgr   ",
        "____s____",
        "____s____",
        "__ _s_ __",
        "____s____",
        "__ _s_ __",
        "____s____",
        "__ _s_ __",
        "____s____",
        "__ ___ __",
        "____p____",
        "  _____  "
    ],
    "spikes": [
        "_________",
        "_________",
        "_________",
        "_________",
        "_________",
        "_________",
        "_________",
        "_________",
        "_________",
        "_________",
        "_________",
        "_________"
    ]
}
