{
    "moves": 12,
    "spikes_move": 0,
    "tiles": [
        "111252111",
        "____3____",
        "____3____",
        "__1_3_1__",
        "____3____",
        "__1_3_1__",
        "____3____",
        "__1_3_1__",
        "____3____",
        "__1___1__",
        "____p____",
        "11_____11"
    ],
    "spikes": [
        "_________",
        "_________",
        "_________",
        "_________",
        "_________",
        "_________",
        "_________",
        "_________",
        "_________",
        "_________",
        "_________",
        "_________"
    ]
}
